10 10
##########
#        #
#   ###  #
#   #  G #
#   #    #
#        #
#        #
#  #######
#   S    #
##########
